+....................................................
.....................................................
.....................................................
.........@..######.........................##......./
....................###..###...........#.............
.........###.....###.........##.....#............##..
#########.......................##...................
-----------------------------------------------------

взять пустой фон как тайл(-) и есл редиска его касается, то умирает