+...................................
....................................
....................................
.........@........................./
.............###....### ###.........
.........###.....###.........##.....
#########.......................##..