+...................................
....................................
....................................
.........@..######.................../
....................###..###.........
.........###.....###.........##.....
#########.......................##..